XXXXXXXXXXXXXXXXXXXXXXXXXXXXXXXX
X   XXXXXX                     X
X   X       XXXXXXXXXXXXXXXXXXXX
X   X  XXXXXXX                 E
X   X        X XXXXXXXXXXXXXXXXX
X XXXXXXXX   X X         X     X
X   X        X X XXXXXXX X XXX X
X   XXXXXX   X X X     X X X X X
X  XXXXXXX   X X X  XX X X X X X
X  X         X X XXXXX X X X X X
X  X XXXXX   X X       X   X X X
X  XXXXXXX   X XXXXXXXXX X X X X
X            X           X X X X
XXXXXXXXXX XXXXXXXXXXXXXXX X X X
X        X XXX           X X   X  
X XXXXXX X XXXXXXXXXXXX X  XXXXX
X XXXXXXXX XXXXXXXXXXXX X      X
X                        XXXXX X
X XX XXX XXXXXXXXXXXXXXX       X
X XX XXX XXXXXXXXXXXXXXXXXXXXXXX
X                              X
XXXXXXXXXXXXXXXXXXXXXXXXXXXXXX X 
X                              X
XXXXXXXXXXXXXXXXXXXXXXXXXXXXXXXX